0	0	0	0	0	0	0	0	0	0	0	0	0	0	0	0	0	0	0	0	0	0	0	0	0	0	0	0	0	0	0	0	0	0	0	0	0	0	0	0	0	0	0	0	0	0	0	0	0	0	0	0	0	0	0	0	0	0	0	0	0	0	0	0
0	9	1	1	1	3	9	1	1	1	1	1	1	1	1	1	1	1	1	1	1	1	1	1	1	1	1	1	1	1	1	1	1	1	1	1	1	1	1	1	1	1	1	1	1	1	1	1	1	1	1	1	1	1	1	1	1	1	1	1	1	1	3	0
0	8	0	0	0	2	8	0	0	0	0	0	0	0	0	0	0	0	0	0	0	0	0	0	0	0	0	0	0	0	0	0	0	0	0	0	0	0	0	0	0	0	0	0	0	0	0	0	0	0	0	0	0	0	0	0	0	0	0	0	0	0	2	0
0	8	0	0	0	2	8	0	0	0	0	0	0	0	0	0	0	0	0	0	0	0	0	0	0	4	0	0	0	0	0	0	0	0	0	0	0	0	0	0	0	0	0	0	0	0	0	0	0	4	0	0	0	0	0	0	0	0	0	0	0	0	2	0
0	8	0	0	0	2	8	0	0	0	0	0	0	0	0	0	0	0	0	0	0	0	0	0	2	0	8	0	0	0	0	4	4	4	4	4	0	0	0	0	4	4	4	4	4	0	0	0	2	0	8	0	0	0	0	0	0	0	0	0	0	0	2	0
0	8	0	0	0	2	8	0	0	0	0	0	0	0	0	0	0	0	0	0	0	0	0	0	2	0	8	0	0	0	2	0	0	0	0	0	8	0	0	2	0	0	0	0	0	8	0	0	2	0	8	0	0	4	4	4	4	4	4	4	4	4	6	0
0	8	0	0	0	2	8	0	0	0	0	0	0	0	0	0	0	0	0	0	0	0	0	0	2	0	8	0	0	0	2	9	1	1	1	1	0	0	0	0	1	1	1	1	3	8	0	0	2	0	8	0	2	0	0	0	0	0	0	0	0	0	0	0
0	8	0	0	0	2	8	0	0	0	0	0	0	0	0	0	0	0	0	0	0	0	0	0	2	0	8	0	0	0	2	8	0	0	0	0	0	0	0	0	0	0	0	0	2	8	0	0	2	0	8	0	0	1	1	1	1	1	1	1	1	1	3	0
0	8	0	0	0	2	8	0	0	0	0	0	0	0	0	0	0	0	0	0	0	0	0	0	2	0	8	0	0	0	2	8	0	0	0	0	4	4	4	4	0	0	0	0	2	8	0	0	2	0	8	0	0	0	0	0	0	0	0	0	0	0	2	0
0	8	0	0	0	2	8	0	0	0	0	0	0	0	0	0	0	0	0	0	0	0	0	0	2	0	8	0	0	0	2	8	0	0	0	2	0	0	0	0	8	0	0	0	2	8	0	0	2	0	12	4	4	4	4	4	4	4	4	4	0	0	2	0
0	8	0	0	0	2	12	4	4	4	4	0	0	0	4	4	4	4	4	4	4	4	4	4	6	0	8	0	0	0	2	8	0	0	4	6	0	0	0	0	12	4	0	0	2	8	0	0	0	1	1	1	1	1	1	1	3	0	0	0	8	0	2	0
0	8	0	0	0	2	0	0	0	0	0	8	0	2	0	0	0	0	0	9	1	1	1	1	1	1	0	0	0	0	2	8	0	2	0	0	0	0	0	0	0	0	8	0	2	8	0	0	0	0	0	0	0	0	0	0	2	9	1	1	0	0	2	0
0	8	0	0	0	2	9	1	1	1	1	0	0	0	1	1	1	1	3	8	0	0	0	0	0	0	0	0	0	0	2	8	0	2	0	0	0	0	0	0	0	0	8	0	2	8	0	0	0	0	0	0	0	0	0	0	2	8	0	0	0	0	2	0
0	8	0	0	0	2	8	0	0	0	0	0	0	0	0	0	0	0	2	8	0	0	0	0	0	0	0	0	0	0	2	8	0	2	0	0	0	0	0	0	0	0	8	0	2	8	0	0	0	0	0	0	0	0	0	0	2	8	0	0	4	4	6	0
0	8	0	0	0	2	8	0	0	0	0	0	0	0	0	0	0	0	2	8	0	0	0	0	4	4	4	4	4	4	6	8	0	2	0	0	0	0	0	0	0	0	8	0	2	12	4	4	4	4	4	4	0	0	0	0	2	8	0	2	0	0	0	0
0	8	0	0	0	2	8	0	0	0	0	0	0	0	0	0	0	0	2	8	0	0	0	2	9	1	1	1	1	1	1	0	0	0	1	1	1	1	1	1	1	1	0	0	0	1	1	1	1	1	1	3	8	0	0	0	2	8	0	0	1	1	3	0
0	8	0	0	0	2	8	0	0	0	0	0	0	0	0	0	0	0	2	8	0	0	0	2	8	0	0	0	0	0	0	0	0	0	0	0	0	0	0	0	0	0	0	0	0	0	0	0	0	0	0	2	8	0	0	0	2	8	0	0	0	0	2	0
0	8	0	0	0	2	8	0	0	4	4	4	4	4	4	4	0	0	2	8	0	0	0	2	8	0	0	4	4	4	4	4	4	0	0	0	0	0	0	0	0	0	0	4	4	4	4	4	4	0	0	2	8	0	0	0	2	12	4	4	0	0	2	0
0	8	0	0	0	2	8	0	2	0	0	0	0	0	0	0	8	0	2	8	0	0	0	2	8	0	2	0	0	0	0	0	0	8	0	0	0	0	0	0	0	0	2	0	0	0	0	0	0	8	0	2	8	0	0	0	2	0	0	0	8	0	2	0
0	8	0	0	0	2	8	0	2	0	0	0	0	0	0	0	8	0	2	8	0	0	0	2	8	0	2	0	0	0	0	0	0	8	0	0	0	0	0	0	0	0	2	0	0	0	0	0	0	8	0	2	8	0	0	0	2	9	1	1	0	0	2	0
0	8	0	0	0	2	8	0	2	0	0	0	0	0	0	0	8	0	2	8	0	0	0	2	8	0	2	0	0	0	0	0	0	8	0	0	0	0	0	0	0	0	2	0	0	0	0	0	0	8	0	2	8	0	0	0	2	8	0	0	0	0	2	0
0	8	0	0	0	2	8	0	0	1	1	1	1	1	1	1	0	0	2	8	0	0	0	2	8	0	2	0	0	0	0	0	0	8	0	0	0	0	0	0	0	0	2	0	0	0	0	0	0	8	0	2	8	0	0	0	2	8	0	0	4	4	6	0
0	8	0	0	0	2	8	0	0	0	0	0	0	0	0	0	0	0	2	8	0	0	0	2	8	0	2	0	0	0	0	0	0	8	0	0	0	0	0	0	0	0	2	0	0	0	0	0	0	8	0	2	8	0	0	0	2	8	0	2	0	0	0	0
0	8	0	0	0	2	8	0	0	0	0	0	0	0	0	0	0	0	2	8	0	0	0	2	8	0	2	0	0	0	0	0	0	8	0	0	0	0	0	0	0	0	2	0	0	0	0	0	0	8	0	2	8	0	0	0	2	8	0	0	1	1	3	0
0	8	0	0	0	2	8	0	0	0	0	0	0	0	0	0	0	0	2	8	0	0	0	2	8	0	0	1	1	1	1	1	1	0	0	0	0	0	0	0	0	0	0	1	1	1	1	1	1	0	0	2	8	0	0	0	2	8	0	0	0	0	2	0
0	8	0	0	0	2	8	0	0	0	0	0	0	0	0	0	0	0	2	8	0	0	0	2	8	0	0	0	0	0	0	0	0	0	0	0	0	0	0	0	0	0	0	0	0	0	0	0	0	0	0	2	8	0	0	0	2	8	0	0	0	0	2	0
0	8	0	0	0	2	12	4	4	4	4	4	4	4	4	4	4	4	6	8	0	0	0	2	12	4	4	4	4	4	4	4	4	4	4	4	4	4	4	4	4	4	4	4	4	4	4	4	4	4	4	6	8	0	0	0	2	12	4	4	4	4	6	0
0	8	0	0	0	0	1	1	1	1	1	1	1	1	1	1	1	1	1	0	0	0	0	0	1	1	1	1	1	1	1	1	1	1	1	1	1	1	1	1	1	1	1	1	1	1	1	1	1	1	1	1	0	0	0	0	0	1	1	1	1	1	3	0
0	8	0	0	0	0	0	0	0	0	0	0	0	0	0	0	0	0	0	0	0	0	0	0	0	0	0	0	0	0	0	0	0	0	0	0	0	0	0	0	0	0	0	0	0	0	0	0	0	0	0	0	0	0	0	0	0	0	0	0	0	0	2	0
0	8	0	0	0	0	0	0	0	0	0	0	0	0	0	0	0	0	0	0	0	0	0	0	0	0	0	0	0	0	0	0	0	0	0	0	0	0	0	0	0	0	0	0	0	0	0	0	0	0	0	0	0	0	0	0	0	0	0	0	0	0	2	0
0	8	0	0	0	0	0	0	0	0	0	0	0	0	0	0	0	0	0	0	0	0	0	0	0	0	0	0	0	0	0	0	0	0	0	0	0	0	0	0	0	0	0	0	0	0	0	0	0	0	0	0	0	0	0	0	0	0	0	0	0	0	2	0
0	8	0	0	0	0	4	4	4	4	4	4	4	4	4	4	4	4	4	4	4	4	4	4	4	4	4	4	4	4	4	4	4	4	0	0	0	0	0	4	4	4	4	4	4	4	4	4	4	4	4	4	4	4	4	4	4	4	4	4	4	4	6	0
0	8	0	0	0	2	9	1	1	1	1	1	1	1	1	1	1	1	1	1	1	1	1	1	1	1	1	1	1	1	1	1	1	3	8	0	0	0	2	9	1	1	1	1	1	1	1	1	1	1	1	1	1	1	1	1	1	1	1	1	1	1	3	0
0	8	0	0	0	2	8	0	0	0	0	0	0	0	0	0	0	0	0	0	0	0	0	0	0	0	0	0	0	0	0	0	0	2	8	0	0	0	2	8	0	0	0	0	0	0	0	0	0	0	0	0	0	0	0	0	0	0	0	0	0	0	2	0
0	8	0	0	0	2	8	0	0	0	0	0	0	0	0	0	0	0	0	0	0	0	0	0	0	0	0	0	0	0	0	0	0	2	8	0	0	0	2	8	0	0	4	4	4	0	0	0	0	0	0	0	0	0	0	0	0	4	4	4	0	0	2	0
0	8	0	0	0	2	8	0	0	0	0	0	0	0	0	0	0	0	0	0	0	0	0	0	0	0	0	0	0	0	0	0	0	2	8	0	0	0	2	8	0	2	0	0	0	8	0	0	0	0	0	0	0	0	0	0	2	0	0	0	8	0	2	0
0	8	0	0	0	2	8	0	0	0	0	0	0	0	0	0	0	0	0	0	0	0	0	0	0	0	0	0	0	0	0	0	0	2	8	0	0	0	2	8	0	2	0	0	0	8	0	0	0	0	0	0	0	0	0	0	2	0	0	0	8	0	2	0
0	8	0	0	0	2	12	4	4	4	0	0	0	4	4	4	4	4	4	4	4	4	4	4	4	4	4	0	0	0	4	4	4	6	8	0	0	0	2	8	0	2	0	0	0	8	0	0	0	0	0	0	0	0	0	0	2	0	0	0	8	0	2	0
0	8	0	0	0	2	0	0	0	0	8	0	2	0	0	0	0	0	0	0	0	0	0	0	0	0	0	8	0	2	0	0	0	0	8	0	0	0	2	8	0	0	1	1	1	0	0	0	0	0	0	0	0	0	0	0	0	1	1	1	0	0	2	0
0	8	0	0	0	2	9	1	1	1	0	0	0	1	1	1	1	1	1	1	1	1	1	1	1	1	1	0	0	0	1	1	1	3	8	0	0	0	2	8	0	0	0	0	0	0	0	0	0	0	0	0	0	0	0	0	0	0	0	0	0	0	2	0
0	8	0	0	0	2	8	0	0	0	0	0	0	0	0	0	0	0	0	0	0	0	0	0	0	0	0	0	0	0	0	0	0	2	8	0	0	0	2	8	0	0	0	0	0	0	0	0	0	0	0	0	0	0	0	0	0	0	0	0	0	0	2	0
0	8	0	0	0	2	8	0	0	0	0	0	0	0	0	0	0	0	0	0	0	0	0	0	0	0	0	0	0	0	0	0	0	2	8	0	0	0	2	8	0	0	0	0	0	0	0	0	0	0	0	0	0	0	0	0	0	0	0	0	0	0	2	0
0	8	0	0	0	2	8	0	0	0	0	0	0	0	0	0	0	0	0	0	0	0	0	0	0	0	0	0	0	0	0	0	0	2	8	0	0	0	2	8	0	0	0	0	0	0	0	0	0	0	0	0	0	0	0	0	0	0	0	0	0	0	2	0
0	8	0	0	0	2	12	4	4	4	0	0	0	4	4	4	4	0	0	0	0	0	0	4	4	4	4	0	0	0	4	4	4	6	8	0	0	0	2	8	0	0	0	0	0	0	0	0	0	0	0	0	0	0	0	0	0	0	0	0	0	0	2	0
0	8	0	0	0	2	0	0	0	0	8	0	2	0	0	0	0	8	0	0	0	0	2	0	0	0	0	8	0	2	0	0	0	0	8	0	0	0	2	8	0	0	0	0	0	0	0	0	0	0	0	0	0	0	0	0	0	0	0	0	0	0	2	0
0	8	0	0	0	2	9	1	1	1	0	0	0	1	1	1	3	8	0	0	0	0	2	9	1	1	1	0	0	0	1	1	1	3	8	0	0	0	2	8	0	0	0	0	0	0	0	0	0	0	0	0	0	0	0	0	0	0	0	0	0	0	2	0
0	8	0	0	0	2	8	0	0	0	0	0	0	0	0	0	2	8	0	0	0	0	2	8	0	0	0	0	0	0	0	0	0	2	8	0	0	0	2	8	0	0	4	4	4	0	0	0	0	0	0	0	0	0	0	0	0	4	4	4	0	0	2	0
0	8	0	0	0	2	8	0	0	0	0	0	0	0	0	0	2	8	0	0	0	0	2	8	0	0	0	0	0	0	0	0	0	2	8	0	0	0	2	8	0	2	0	0	0	8	0	0	0	0	0	0	0	0	0	0	2	0	0	0	8	0	2	0
0	8	0	0	0	2	8	0	0	0	0	0	0	0	0	0	2	8	0	0	0	0	2	8	0	0	0	0	0	0	0	0	0	2	8	0	0	0	2	8	0	2	0	0	0	8	0	0	0	0	0	0	0	0	0	0	2	0	0	0	8	0	2	0
0	8	0	0	0	2	8	0	0	0	0	0	0	0	0	0	2	8	0	0	0	0	2	8	0	0	0	0	0	0	0	0	0	2	8	0	0	0	2	8	0	2	0	0	0	8	0	0	0	0	0	0	0	0	0	0	2	0	0	0	8	0	2	0
0	8	0	0	0	2	8	0	0	0	0	0	0	0	0	0	2	8	0	0	0	0	2	8	0	0	0	0	0	0	0	0	0	2	8	0	0	0	2	8	0	0	1	1	1	0	0	0	0	0	0	0	0	0	0	0	0	1	1	1	0	0	2	0
0	8	0	0	0	2	8	0	0	0	0	0	0	0	0	0	2	8	0	0	0	0	2	8	0	0	0	0	0	0	0	0	0	2	8	0	0	0	2	8	0	0	0	0	0	0	0	0	0	0	0	0	0	0	0	0	0	0	0	0	0	0	2	0
0	8	0	0	0	2	8	0	0	0	0	0	0	0	0	0	2	8	0	0	0	0	2	8	0	0	0	0	0	0	0	0	0	2	8	0	0	0	2	12	4	4	4	4	4	4	4	4	4	4	0	0	0	0	4	4	4	4	4	4	4	4	6	0
0	8	0	0	0	2	12	4	4	4	4	4	4	4	4	4	6	8	0	0	0	0	2	12	4	4	4	4	4	4	4	4	4	6	8	0	0	0	2	0	0	0	0	0	0	0	0	0	0	0	8	0	0	2	0	0	0	0	0	0	0	0	0	0
0	8	0	0	0	0	1	1	1	1	1	1	1	1	1	1	1	0	0	0	0	0	0	1	1	1	1	1	1	1	1	1	1	1	0	0	0	0	0	1	1	1	1	1	1	1	1	1	1	1	0	0	0	0	1	1	1	1	1	1	1	1	3	0
0	8	0	0	0	0	0	0	0	0	0	0	0	0	0	0	0	0	0	0	0	0	0	0	0	0	0	0	0	0	0	0	0	0	0	0	0	0	0	0	0	0	0	0	0	0	0	0	0	0	0	0	0	0	0	0	0	0	0	0	0	0	2	0
0	8	0	0	0	0	0	0	0	0	0	0	0	0	0	0	0	0	0	0	0	0	0	0	0	0	0	0	0	0	0	0	0	0	0	0	0	0	0	0	0	0	0	0	0	0	0	0	0	0	0	0	0	0	0	0	0	0	0	0	0	0	2	0
0	12	4	4	4	4	4	4	4	4	4	4	4	4	4	4	4	4	4	4	4	4	4	4	4	4	4	4	4	4	4	4	4	4	4	4	4	4	4	4	4	4	4	4	4	4	4	4	4	4	4	4	4	4	4	4	4	4	4	4	4	4	6	0
0	0	0	0	0	0	0	0	0	0	0	0	0	0	0	0	0	0	0	0	0	0	0	0	0	0	0	0	0	0	0	0	0	0	0	0	0	0	0	0	0	0	0	0	0	0	0	0	0	0	0	0	0	0	0	0	0	0	0	0	0	0	0	0
